SO  ./texture/so.xpm
NO  ./texture/no.xpm
WE  ./texture/we.xpm
EA  ./texture/ea.xpm 

C 0,181,226
F 112,128,144



        1111111111111111111111111
        10000101001100000N0000001
        1001111100111000000000001
        1001000000000000000000001
111111111011000001110000000000001
100000000011000001110000000000001
111101111111110111000000100011111
11110111111111011101010010001
1100010110101011100000010001
10000000000000001100000010001
10000000000000001101010010001
1100000111010101111101111000111
11110111 1110101 101111010001
11111111 1111111 111111111111