SO ./texture/so.xpm  
NO  ./texture/no.xpm
WO  ./texture/wo.xpm
EA  ./texture/ea.xpm 

C 47,79,79
F 112,128,144



        11111111111111111111111111
        1000000000110000000N000001
        10000000001100000000000001
        10110000011100000000000001
        10010000000100000000000001
1111111110110000011100000000000001
1000000000110000011101111111111111
11110111111111011100000010001
11110111111111011101010010001
11000000110101011100000010001
10000000000000001100000010001
11111111111111111111111111111
11000001110101011111011110001
11110111 1110101 111110100011
11111111 1111111 111111111111


